#########
#@      #
#    $  #
#       #
#       #
#       #
#.      #
#########