  ####
###  #
#@$. #
# .$ #
##$.###
 #    #
 #    #
 ###  #
   ####