   ####
  ##  ##
### @$.##
#    $. #
#   #$. #
##### # #
    #   #
    #####