    ####
 ####  #
 # $ $ #
##.#$@ #
# .. # #
#  . $ #
###  ###
  ####