######
#  ..####
# #...  #
# $  $  #
#### #$##
 # $ $@#
 #   ###
 #####