####
#  ####
#@*   ##
# $.*$.#
#    # #
##$ ## #
 #    .#
 #######