  ######
###    #
#@$ ## #
#  $.* #
# #$ .##
#.$. ##
#    #
######