#####
#@  ####
#  *$  #
# *..  #
##$* ###
#    #
#   ##
#####