   ####
####  ###
#    $  ##
# #  #@$ #
# $ *.*# #
## #...  #
 #   #$###
 ###   #
   #####