   ####
####  ###
#   ..  ##
# # .#.  #
# $ $..# #
##$#$  $ #
 #   #$###
 ###  @#
   #####