  #####
  #   #
###   ######
# $.$ .#   #
# #*# *    #
#@$. $.#####
###   ##
  #####