   #####
 ###...##
##  *.. ###
#  #  #   #
# #   $$# #
#   #$$@$ #
###    ####
  ######