 #####
##   ###
#  # $ #
# $$ $ #
# ..#$ #
##...  #
 #..$###
 #$# #
 #@  #
 #####