  #####
  #   #
### #$###
# $  $  #
#@# $ # #
#.*.....#
###$$ ###
  #   #
  #####