   ####
####  ##
# $ .* #
#@$*   #
# $ #. #
###   .#
  ######