########
#@ # . #
# **.  #
# $ .* #
##$$  ##
 #    #
 ######