    #####
#####   #
# $...  #
#@#*$.$ #
# $.*.# #
##   #  #
 # #$$ ##
 #   ###
 #####