########
#      #
# $# # #
#   .*.###
# $#*#.$ #
# $ ...# #
####$#$ @#
   #    ##
   ######