  #####
### @ ###
#  $#$  #
#  ...  #
#  .$.  #
###...###
  ## ##
   # #
#### ####
#  $$$  #
# #  ## #
# #$ $  #
# #  # ##
#      #
########