     ####
   ###  #
   # $ $#
   # #  ##
####...  #
#   *.*#$##
# # ...   #
#  $# #$# #
###@$   $ #
  ### # ###
    #   #
    #####