  #########
###       ###
# $$$... $  #
#@# #**.# # #
# $  ..*  $ #
#####   #####
    #####