####
#  ###########
#    $ $ $ $ #
#  #. . . .  #
## ######## ##
#  . . . .#  #
# $ $ $ $    #
########### @#
          ####