##############
#     ####   #
# $$  ###    #
## $  ###    #
## $ ####   ##
## $ ####   ##
##   #  ##  ##
## $##....  ##
## $... ##  ##
## $# #.##  ##
##  # @ ##  ##
##  ##########
##############