#######
#  +  #
# *** #
# $.$ #
# $.$ #
#  .  #
#######