       ######
 ####  #    #
 # @#### ## ##
## $#  #...  #
#  $ $ #.#.# #
# $ $  $...# #
## $  $ ## # #
 ## ###    # #
  #   ###### #
  ###        #
    ##########