                     ######
########################  #
#      #######   #######  #
#  $ $$#   ### # #   ###  #
# # $  #....     #....   ##
# $$ $$##  ### ####  ##   #
# # $  ## ####  ### ###   #
#  $ $$     #....     #   #
# ## # ## # #   ### # ##  #
#@     ##   #######   ##  #
###########################