         #####
   #######   #
####  $    # #
#    ##### $ #
# #  ...*..###
#   ## # # $ #
###  #   #@# #
  ## ###$$   #
   #     #####
   #######