#######
####  #
#  *  #
#  *  #
#  *@ #
#  ####
#######