  #####
         ###
            ##
#########    ##
 #     #     ##
 # # # ########
 #            ##
 ### # ######  #
 # $ # .     # #
 #@$ # .#### # #
 # $ # .     # #
 ###        #  #
   #   ####   #
   #####  #####