     #####
   ###   #
   #   # #
   # #   #
####  ##$########
#   #$  $ #     ##
#   $ #$# # # #  #
# # # #   #....  #
# $   ## $@  #.  #
# # #$## ##....  #
#   $    ## # #  #
######   ##     ##
     ############