#######
#  #  ####
#  # $   ##
#  ...#$  #
## #$ # # #
#  .*.# $ #
#  #$   ###
#  # @###
#######