   ######
   #    #
   #    ####
#### # ##  ##
#  $   # $  #
# @$#.....# #
### # #$#$  #
  #   #    ##
  ####  #  #
     #  ####
     #  #
     ####