     #####
######   ##
#   $.$   #
# #$#.#$# #
#  ..+..# #
# #$#.#$# #
# # $.$   #
# # #$### #
#         #
###########