   ###
   #.#
   #.#
####.##
#  #.@##
#  #.  ##
#  #.$$ #
# $ #$  #
#   # $.#
## $  $ #
 #    ###
 ######