################
#   ##     #   #
#   $ $ ##. .  #
## #$ $###. .###
 #  $@$ # . .  #
 ### ## #      #
  #     ### ####
  #  ## ###  #
  #  #       #
  ####   ##  #
     #########