########
#      #
# #### #
# .$.  #
##$#$# ##
 #.$.   #
 # ## # #
 #@     #
 ########