######
#    #
#@$. #
#    #
######