 #######
##@$. .#
#.$# # ##
# .$    #
#$# #   #
#   #####
#####