    #######
    #     #
    #  #  #
##### ### #####
#..  $   $  ..#
#.. $ $ $ $ .+#
###  $   $ ####
  ### ## ###
    #    #
    ######