    #####
#####  .#
#.    @ #
# $$$   #
### #####
##   ####
#.      #
#  $  . #
#     ###
#######