#######
# .* .#
#.$$  #
#.$ $.#
#$$$ *#
#+$.. #
#######