 ########
 #....* #
 #####. ###
   #.**$  #
   #  $   #
   # #  # #
####$ # $ #
# $     $##
# @###   #
#### #####