 #######
 #.@#  #
##*$$  #
#. $   #
#   . ##
#######