   #####
  ##.  ##
  #   $ ##
 ##$ ##  ##
##@ ###   #
#..$   ## #
###$   #  #
 #   # #  #
 #    .   #
 ##########