 #######
 #..  .#
##@#.. #
#  $ $ #
#.# #$ #
# $$  $#
#      #
########