       ####
 #######..#
 # $      #
##  #  .  #
#@   ##   #
#### $ $$##
   #$  #  #
   # # #  #
   #. . $.#
   ########