   ######
  ##....#
###  ..##
#@#$$$ #
# $   ##
###$# ###
 #      #
 # $    #
 ##  ####
  ####