   ############
   #   .......#
#### #@#$####$###
# $    $ $   $  #
#  $###     # # #
#   # ####  #   #
##  #    #  #####
 ####    ####