   ######
  ##    #
### ... #
#.#. #$###
#   $    #
#  $#  $ #
###+$ #  #
  #####$ #
      #  #
      ####