    #####
    #  @#
#####$#$#
#   $ # ##
#   #    #
#  $$..# #
# # #.#  #
#   ##  ##
##$..*.##
 #  ####
 ####