    #####
#####.* #
#.  #  *#
# # $ ###
#..$  $ #
#  $ #$@#
#    #. #
#    ####
######