 ######
 #.##.#
 #.##.#
##..$$##
#.$$#@ ###
### ##$$ #
#   # $  #
#        #
###  .#$ #
  #####  #
      ####