####
#..#####
#..    ##
# $  #$ #
####  $ #
 #@$    #
 ####   #
    #####