#######
#.  ..#
# # ##########
# $  $ $  $  #
# #. # @$    #
# ##$## ######
#.     .#
#########