###  ###
#.####.##
#. #    #
# .     #
# ##. $ #
# $ * $##
##@$   ###
 #### $  #
    #    #
    ######