#######
# . * #
#.*$ .#
# $ $ #
#*$ .*#
#@* * #
#######