     ####
######  ##
#.*.*. $ #
##*.###  #
 # .# #$ #
 #$.###@ #
 #   . $ #
 ## $  $ #
  #####$ #
      #  #
      ####