######
#.##.###
#.##   ###
#. #  .  #
#        #
#.$   # ##
####. $ #
#  #$# ###
# $ $ $$ #
#    @   #
##########