 #########
 #   #   #
 # #   # #
 # $ # $ #
####$. ####
# $ ...$  #
#@#$# # # #
# $ ..*   #
#####.#####
    ###