  ######
  #    #
###$   #
# $  * ##
#.****  #
#+$ .   #
#########