 ########
## * .. ##
# .  $ * #
#   *$   #
###$ #####
  #  @#
  #####