  ####
  #  ###
 ##  ..#
 #@$.*.#
### #.##
#  $$ ##
#   #  #
##$$   #
 #    ##
 ######