    #####
#####.**#
#.  #   #
# # $ ###
#..$  $ #
#  $ #$ #
#    #. #
#    ##@#
#########