   ####
#### @#
#  **$####
#....    #
# ..##$  #
## ##  # #
 #  # $  #
 # $ $ $ #
 ##    ###
  ######