    ###
 ####.#
 #..*.#
##* $$#
#..*$@#
# $  ##
#  $###
##$   #
 #  # #
 ##   #
  #####