#############
#        #  #
# $ @$ $   $######
# ## ### $  $    #
# .. ..##.##  $  #
# #  .# #.###$#$ #
#       #.   $   #
#########.  #. ###
        ########