######
#.   ###########
# $ $    $ $   #
###    ###.### #
  #.##.#   $.  #
  #  . # $. #$+#
  ## # ## #    #
  #  $  # ######
  # .#. # $ $ #
  #  #  #     #
  #############