#######
#     #
# .$@ #
# $$  #
#  .  #
#######
