    ###########
####    +#..  #
#  $ $   #    #
# # $    ## $ #
#   #..       #
###############